000000000000000000000000000000000000000000000000000000000000000000000000000000000000000000000000000000000000000000000000000000000000000000000000000000000000000000000
0000000000000000000000000000000000000000000000000000000000000000000000000000000000000000000DEF0000J000000000000000000000000000000000000000000000000000000000000000000
0000000000000000000000000000000000000000000000000000000000000000000000000000000000000000000000000DEF00000000000000000000000000000000000000000000000000000000000000000
000000000000000000000000000000000000000000000000000000000000000000000012222222222222222230000000000000012222222222222223000000000000000000000000000000000000000000000
00000000000000000000000000000000000000000000000000000000000000000DEF0045555555555555555560000000000000045555555555555556000000000000000000000000000000000000000000000
1222223000000000000000000000000000000000000000000000000000001230000000455555555555555555600000000000000455555555555555560J0J00000000000J00000000000000000000000000000
455555600000000000000000000000000000DEF000DEF000000012223000456000000045555555555555555560000000000000045555555555555556122230000J000DEF00000000000000000000000000000
45555560000000000000000000000000000000000000000000004555600045600000004555555555555555556HHHHHHHHHHHHHH4555555555555555645556000DEF000000J0J0000000000000000000000000
455555600000000000000000000000J00000000000000000000045556JJJ456JJJJ0004555555555555555556IIIIIIIIIIIIII4555555555555555645556000000000000DEF0000122222222222225555555
455555AB2222222222223HHH1222222222230000000001222223122222222222223HHH4555555555555555556IIIIIIIIIIIIII45555555555555556455560000000000000000000455555555555555555555
455555555555555555556III4555555555560000000004555556455555555555556III4555555555555555556IIIIIIIIIIIIII45555555555555556455560000000000000000000455555555555555555555
455555555555555555556III4555555555560000000004555556455555555555556III45555555555555555555555555555555555555555555555556455560000000000000000000455555555555555555555
455555555555555555556III455555555556HHHHHHHHH4555556455555555555556III45555555555555555555555555555555555555555555555556455560000000000000000000455555555555555555555
000000000000555555556III455555555556IIIIIIIII4555556455555555555556III4555555600000000000000000000000000000000000000005645556HHHHHHHHHHHHHHHHHHH455555555555555555555
000000000000000000000000000000055556IIIIIIIII4555556455555555555556III4555555600000000000000000000000000000000000000005645556IIIIIIIIIIIIIIIIIIII55555555555500000000
00000000000000000000000000000000000000000000000000000000000000000000000000000000000000000000000000000000000000000000005645556IIIIIIIIIIIIIIIIIIII55555555555500000000
000000000000000000000000000000000000000000000000000000000000000000000000000000000000000000000000000000000000000000000000000055555555555555555555550000000000000000000
